171 171 171 171 171 171 171 171 171 171 171 171 171 171 171 171 171 171 171 171 171 171 171 171 171 171 171 171 171 171 171 171 171 171 171 171 171 171 171 171 171 171 171 171 171 171 171 171 171 171 171 171 171 171 171 171 171 171 171 171 171 171 171 171 171 171 171 171 171 171 171 171 171 171 171 171 171 171 171 171 171 171 171 171 171 171 171 171 171 171 171 171 171 171 171 171 171 171 171 171 
171 8 8 8 9 8 8 8 8 8 8 8 8 8 10 8 8 8 8 8 8 8 8 8 9 8 8 8 8 8 8 8 9 8 86 13 13 13 87 8 11 8 8 9 9 8 56 55 55 55 55 55 55 55 26 4 4 4 4 4 4 4 4 34 25 0 0 0 0 1 0 0 0 0 0 0 0 0 0 0 0 0 0 0 0 0 0 0 0 0 0 0 0 0 0 0 0 0 50 171 
171 8 8 8 8 8 8 8 8 10 8 8 108 114 114 114 114 114 114 114 114 114 114 109 10 8 8 8 8 8 8 8 8 8 86 13 13 13 87 8 8 8 8 8 8 8 51 0 0 0 0 0 2 0 28 33 4 4 4 4 4 5 4 32 29 0 0 0 0 0 0 0 0 0 0 0 0 0 0 1 0 0 0 0 0 0 0 0 0 0 1 0 0 0 0 0 0 0 50 171 
171 8 8 8 8 8 8 8 8 8 108 114 119 16 16 16 16 16 16 16 16 16 16 118 114 109 8 8 8 8 8 8 8 8 86 14 13 13 87 8 8 8 8 8 8 8 51 0 0 0 0 0 0 0 156 158 159 159 159 159 159 159 159 160 161 36 42 42 42 37 0 0 0 0 0 0 0 0 0 1 0 0 0 0 0 0 0 0 0 0 0 0 0 1 0 0 0 48 59 171 
171 9 8 8 8 10 8 10 108 114 119 18 16 17 16 16 16 16 18 16 16 17 16 16 16 118 109 8 8 8 8 8 11 8 86 13 13 13 87 8 8 9 8 8 8 8 51 0 0 0 1 0 0 0 168 169 169 169 169 169 169 169 169 169 170 38 7 6 6 39 0 0 0 0 0 0 0 0 0 0 0 0 0 0 1 0 0 0 0 0 0 0 0 1 0 0 0 50 8 171 
171 8 8 8 8 108 114 114 119 16 16 16 16 16 16 132 138 138 138 138 133 16 16 16 16 16 118 109 10 8 8 8 8 8 86 13 13 13 87 8 8 8 8 8 8 8 51 0 0 0 0 0 0 0 162 164 165 165 165 165 165 165 165 166 167 40 43 45 6 39 0 0 0 1 0 0 0 36 42 37 0 0 0 0 0 0 0 0 0 0 0 0 0 0 0 0 0 50 8 171 
171 8 8 10 108 119 16 16 16 16 132 138 138 138 138 143 21 23 21 21 142 138 133 16 16 16 16 111 8 8 8 8 8 8 86 13 13 13 94 85 8 8 8 8 8 8 51 0 0 0 0 0 0 0 24 35 4 4 4 4 4 4 4 27 0 0 0 38 6 39 0 0 0 0 0 0 0 38 6 39 0 0 0 0 0 0 0 0 0 0 0 0 48 54 54 54 54 59 8 171 
171 8 8 8 110 16 16 17 16 138 143 21 21 21 21 21 21 21 21 21 21 21 142 138 16 16 16 118 109 8 8 8 8 8 88 93 13 13 13 94 85 8 8 11 8 8 51 0 2 0 0 0 0 0 26 4 4 4 4 4 5 4 32 29 0 0 0 38 6 39 0 0 0 0 0 0 0 38 7 39 0 0 1 0 0 0 0 0 0 0 0 0 50 8 8 8 8 8 8 171 
171 8 8 108 119 16 16 16 134 21 22 21 144 150 150 150 150 145 22 21 21 21 23 21 135 16 18 17 111 10 9 9 8 8 8 86 13 13 14 13 87 8 9 8 8 8 51 0 0 0 0 0 0 0 26 4 4 5 4 4 4 4 27 0 0 0 0 38 6 46 42 42 42 42 42 42 42 47 6 39 0 0 0 0 0 0 0 0 0 48 54 54 59 8 8 8 8 9 8 171 
171 8 10 110 16 16 16 132 143 23 21 21 155 19 20 19 19 147 21 144 150 145 21 21 135 16 16 16 111 8 8 9 8 8 8 88 93 13 13 13 87 8 8 8 8 8 51 0 0 0 0 0 0 0 26 4 4 4 4 4 4 32 29 0 0 0 0 38 7 6 6 6 6 6 7 6 6 6 6 39 0 0 0 0 0 0 48 54 54 59 8 8 8 8 8 8 8 8 8 171 
171 8 8 110 16 17 16 134 21 21 21 146 19 19 19 19 152 149 144 155 19 147 21 21 135 16 16 16 111 8 8 8 11 8 8 8 86 13 13 13 87 8 8 8 8 8 51 0 0 0 0 0 0 24 35 4 4 4 4 5 4 27 0 0 1 0 0 38 6 44 43 43 43 43 43 43 43 43 43 41 0 0 0 48 54 54 59 8 8 9 9 8 8 8 8 8 8 8 8 171 
171 9 8 110 16 16 16 134 21 21 21 146 19 20 19 152 149 21 146 19 19 147 21 22 135 16 16 16 111 8 8 8 8 8 84 90 95 13 13 13 87 8 8 8 8 56 53 0 1 0 0 0 0 26 4 4 4 4 4 4 4 27 0 0 0 0 0 38 6 39 60 67 67 67 67 67 67 71 0 0 0 0 0 50 8 8 8 8 8 8 8 8 8 9 8 8 8 8 8 171 
171 8 8 110 16 18 16 134 23 21 21 146 20 19 152 149 21 21 148 151 151 149 21 21 135 16 16 16 111 10 8 8 8 84 95 13 13 14 13 13 87 8 8 8 8 51 0 0 0 0 0 0 0 26 4 4 4 4 4 4 4 27 0 0 0 0 0 38 6 39 62 0 0 0 0 0 0 0 0 48 54 54 54 59 8 8 8 8 8 8 8 8 8 8 8 8 9 8 8 171 
171 8 10 112 117 16 16 134 21 21 21 146 19 19 147 21 21 22 23 21 21 21 21 140 16 16 16 16 111 10 8 8 84 95 13 13 13 13 13 92 89 8 8 8 9 51 0 0 0 0 0 0 24 35 5 4 5 4 4 4 32 29 0 0 0 0 0 38 6 39 62 0 0 1 0 0 0 0 48 59 8 8 8 8 8 8 8 8 8 8 8 8 8 8 8 8 8 8 8 171 
171 8 8 8 110 16 16 136 141 22 21 148 151 151 149 21 21 21 21 140 139 139 139 137 17 16 18 116 113 8 8 84 95 13 13 13 13 92 91 89 8 8 8 8 8 51 0 0 0 0 0 0 26 4 4 4 4 4 4 4 27 0 0 0 0 0 0 38 6 39 62 0 0 0 0 0 0 48 59 8 11 8 8 72 78 78 78 78 78 78 78 78 78 78 78 73 8 8 8 171 
171 8 8 10 110 16 16 16 136 141 21 21 21 144 150 150 145 21 140 137 16 16 16 16 16 16 16 111 8 84 90 95 13 14 13 13 92 89 8 8 8 8 8 8 56 53 0 0 0 0 0 0 26 4 4 4 4 4 4 4 27 0 0 0 0 0 0 38 6 39 62 0 0 0 0 48 54 59 8 8 8 9 8 74 4 4 4 4 4 4 4 4 4 4 4 82 73 8 8 171 
171 10 8 8 110 16 18 16 16 136 21 23 21 146 19 19 147 21 135 16 16 16 16 16 16 16 116 113 84 95 13 13 13 13 13 92 89 8 8 8 9 8 8 56 53 0 0 2 0 0 0 24 35 4 4 4 4 4 4 32 29 0 0 0 0 0 0 38 6 39 62 0 0 48 54 59 8 8 84 90 85 8 8 74 4 4 80 79 79 79 79 81 4 4 5 4 75 8 8 171 
171 8 8 8 112 117 16 16 16 136 141 21 21 146 19 19 147 140 137 16 16 16 16 16 116 115 113 8 86 13 13 13 13 92 91 89 8 8 8 8 8 8 56 53 0 0 0 0 0 0 0 26 4 4 4 4 4 5 4 27 0 0 0 1 0 0 0 38 7 39 71 1 0 50 8 8 11 8 86 13 87 8 8 74 4 4 75 72 78 78 73 74 4 4 4 4 82 73 8 171 
171 8 8 10 108 119 16 16 17 16 136 141 22 146 19 152 149 135 16 16 16 17 16 116 113 8 84 90 95 13 13 13 92 89 8 8 8 8 8 8 8 56 53 0 0 0 0 0 0 0 0 26 4 4 4 4 4 4 4 27 0 0 0 0 0 0 0 38 6 39 0 0 0 50 8 8 8 8 86 13 87 8 72 83 4 4 75 74 4 5 75 74 4 80 81 4 4 75 8 171 
171 9 8 108 119 16 16 16 16 16 16 134 21 148 151 149 21 135 16 16 16 16 116 113 10 8 86 13 13 13 13 92 89 8 8 8 8 9 8 56 55 53 0 0 0 0 1 0 0 0 24 35 4 5 4 4 4 4 32 29 0 0 0 0 0 0 0 38 6 39 0 0 0 50 8 8 8 8 86 13 87 8 74 4 4 4 75 74 4 4 75 74 4 75 74 4 4 75 8 171 
171 11 108 119 16 16 18 16 16 18 16 134 21 21 21 22 21 135 16 16 16 116 113 8 8 8 86 13 13 13 13 87 8 8 9 8 8 8 56 53 0 0 0 0 0 0 0 0 0 24 35 4 4 4 4 4 4 32 29 0 0 0 0 0 0 0 0 38 6 39 0 0 0 52 57 8 8 8 86 14 87 8 74 5 5 4 75 76 79 79 77 74 4 75 74 4 4 75 8 171 
171 8 110 16 17 16 16 16 16 16 16 134 21 23 21 21 140 16 16 16 16 111 8 84 90 90 95 13 14 13 13 87 8 8 8 8 8 8 51 0 0 0 0 0 0 0 0 0 24 35 4 4 4 4 4 4 4 27 0 0 0 0 36 42 42 42 42 47 6 39 0 0 0 0 50 8 8 8 86 14 87 8 74 4 4 4 82 78 78 78 78 83 4 75 74 4 4 75 8 171 
171 8 110 16 16 16 16 17 16 16 16 136 139 139 139 16 16 16 16 116 115 113 8 86 13 13 13 13 13 13 13 87 8 11 8 8 56 55 53 0 0 0 0 1 0 0 0 0 26 4 4 4 4 4 4 4 32 29 0 0 0 0 38 6 6 6 6 7 6 39 0 0 0 0 50 8 8 8 86 13 87 8 74 4 4 4 4 4 4 5 4 4 4 75 74 4 5 75 8 171 
171 85 112 115 115 117 16 16 16 16 16 16 16 16 16 16 16 16 16 111 84 90 90 95 13 13 13 13 13 13 92 89 8 8 56 55 53 0 0 0 2 0 0 0 0 0 0 24 35 4 4 4 5 4 4 32 29 0 0 0 0 0 38 6 44 43 43 43 43 41 0 0 0 0 52 55 57 8 86 13 87 8 74 4 4 4 80 79 79 79 79 79 79 77 74 4 4 75 8 171 
171 94 90 90 90 90 129 16 16 18 16 16 16 16 16 16 16 16 116 113 86 13 13 13 14 13 13 13 13 13 87 8 8 8 51 0 0 0 0 0 0 0 0 0 0 0 0 26 4 4 4 4 5 4 32 29 0 0 0 1 0 0 38 7 39 0 0 0 0 0 0 1 0 0 0 0 50 8 86 13 87 8 76 81 5 4 82 78 78 78 78 78 78 78 83 4 80 77 8 171 
171 13 13 13 13 15 15 129 16 16 16 16 16 16 17 16 16 116 113 84 95 13 13 13 13 13 13 13 92 91 89 8 56 55 53 0 0 0 0 0 0 0 0 0 0 0 24 35 4 4 4 4 4 32 29 0 0 0 0 0 0 0 38 6 39 0 0 1 0 0 0 0 0 0 0 0 50 8 86 14 87 8 8 74 4 4 4 4 4 4 4 4 4 4 4 80 77 8 8 171 
171 13 13 13 13 13 13 124 129 16 16 17 16 16 16 16 116 113 84 95 13 13 13 13 92 91 91 91 89 8 8 8 51 0 0 0 0 0 1 0 0 0 0 0 0 24 35 4 4 4 4 5 32 29 0 0 0 0 0 0 0 0 38 6 39 0 0 0 0 0 0 0 0 0 0 0 50 8 86 13 87 8 8 76 79 81 4 4 4 4 4 4 5 4 80 77 8 8 8 171 
171 14 13 13 13 13 13 13 124 129 16 16 16 16 16 116 113 8 86 13 13 13 13 13 87 8 8 8 9 8 8 8 51 0 0 0 0 0 0 0 0 0 0 0 24 35 4 4 4 4 4 4 27 0 0 0 0 0 0 0 0 0 38 6 39 0 0 0 0 0 0 0 0 0 0 48 59 8 86 13 87 8 8 8 8 74 4 4 4 4 4 4 4 4 75 8 8 8 8 171 
171 13 13 13 13 13 13 13 15 122 16 16 16 16 116 113 84 90 95 13 13 14 13 92 89 8 8 8 8 8 8 56 53 0 0 0 0 0 0 0 0 0 24 30 35 4 4 4 4 4 4 32 29 0 0 0 0 0 0 0 0 0 38 6 39 0 0 0 0 0 0 0 0 0 48 59 8 8 86 13 87 8 9 8 8 74 4 5 4 4 4 4 4 4 75 8 8 8 9 171 
171 13 13 13 13 13 13 13 13 124 127 127 127 129 111 84 95 13 13 13 13 92 91 89 8 8 8 8 8 8 8 51 0 0 0 0 0 0 0 0 24 30 35 4 4 5 4 4 4 4 32 29 0 0 0 0 0 0 1 0 0 0 38 6 39 0 0 0 1 0 0 0 0 48 59 8 8 8 86 13 87 8 8 8 8 76 81 4 4 4 4 5 4 4 75 8 8 8 8 171 
171 13 13 13 13 14 13 13 13 13 13 15 13 124 125 15 13 13 13 13 92 89 8 8 8 56 55 55 55 55 55 53 0 0 0 0 0 0 24 30 35 4 4 4 4 4 4 4 4 4 27 0 0 0 0 0 0 0 0 0 0 0 38 6 39 0 0 0 0 0 0 48 54 59 11 8 9 8 86 14 87 8 11 8 8 8 74 4 4 5 4 4 4 4 75 8 8 8 8 171 
171 13 13 13 13 13 13 13 13 13 13 13 13 13 13 13 13 13 13 92 89 8 9 8 8 51 0 0 0 0 0 0 0 0 1 0 0 0 26 4 4 4 4 4 4 4 4 4 4 32 29 0 0 0 0 0 0 0 0 0 0 0 38 6 39 0 0 0 0 48 54 59 8 8 8 8 8 8 86 13 87 8 8 8 8 8 76 79 79 79 79 79 79 79 77 8 8 8 8 171 
171 13 13 13 13 13 13 13 13 13 13 13 13 14 13 13 13 13 13 87 8 8 8 8 8 51 0 2 0 0 0 0 0 0 0 0 24 30 35 4 4 4 4 4 4 4 4 4 5 27 0 0 0 0 0 0 0 0 0 0 0 0 38 7 39 0 1 0 0 50 84 90 90 90 90 90 90 90 95 13 94 90 90 90 85 8 8 8 8 84 90 85 8 8 8 8 8 8 8 171 
171 13 13 13 13 13 13 13 13 13 13 13 13 13 13 13 13 13 92 89 8 11 8 8 8 58 54 54 49 1 0 0 0 0 0 0 26 4 4 4 4 4 5 4 4 4 4 4 32 29 0 0 1 0 0 0 0 0 0 0 0 0 38 6 39 0 0 0 0 50 86 13 13 14 13 13 13 13 13 13 13 13 13 13 87 11 8 8 8 86 13 87 8 8 8 11 8 8 8 171 
171 14 13 13 13 13 13 13 13 13 13 13 13 13 13 13 92 91 89 8 8 8 8 8 9 8 8 8 51 0 0 0 0 0 0 24 35 4 4 4 4 4 4 4 4 4 4 32 29 0 0 0 0 0 0 0 0 0 0 0 0 0 38 6 39 0 0 0 0 50 86 13 13 13 13 13 14 13 13 13 13 13 14 13 87 8 8 8 8 86 14 87 8 8 8 8 8 9 8 171 
171 13 13 13 92 91 91 91 91 91 91 91 91 91 91 91 89 8 8 11 8 11 8 8 8 8 8 8 58 54 54 49 0 156 157 158 159 159 159 159 159 159 159 159 159 159 159 160 157 161 0 0 0 0 0 0 0 0 0 1 0 0 38 6 39 0 0 0 0 50 88 91 91 91 91 91 91 91 91 91 91 93 13 13 94 90 90 90 90 95 13 94 90 90 85 8 8 8 8 171 
171 13 92 91 89 8 8 8 8 11 8 8 8 96 97 8 8 8 8 8 8 8 8 8 8 9 8 8 8 8 8 51 0 168 169 169 169 169 169 169 169 169 169 169 169 169 169 169 169 170 36 42 42 42 42 42 42 42 42 42 42 42 47 6 46 42 42 37 0 52 55 55 55 55 57 8 8 8 9 8 8 86 13 13 13 13 13 13 13 13 13 13 13 13 87 8 8 8 8 171 
171 92 89 8 8 8 96 102 97 8 8 8 8 100 101 8 8 8 8 8 8 56 55 55 55 55 57 8 8 8 9 51 0 168 169 169 169 169 169 169 169 169 169 169 169 169 169 169 169 170 38 6 7 6 6 6 7 6 6 6 6 6 6 6 6 6 6 39 0 0 0 0 0 0 52 55 57 8 8 8 8 86 13 13 13 14 13 13 13 13 13 13 14 13 94 90 90 90 90 171 
171 89 8 11 8 96 107 21 106 102 102 97 8 8 8 8 8 8 8 8 8 51 0 0 0 2 50 8 8 8 8 51 0 168 169 169 169 169 169 169 169 169 169 169 169 169 169 169 169 170 40 43 43 43 43 43 43 43 43 43 43 43 43 43 43 45 7 39 0 0 0 0 0 0 0 0 52 55 57 12 8 88 91 91 91 91 91 91 91 91 91 93 13 13 13 13 13 13 13 171 
171 8 8 8 8 98 21 21 22 21 21 99 8 8 8 8 8 8 9 8 8 51 0 0 0 0 52 55 55 55 55 53 2 162 163 164 165 165 165 165 165 165 165 165 165 165 165 166 163 167 0 0 0 0 0 0 0 0 0 0 0 0 0 0 0 38 6 39 0 0 0 1 0 0 0 0 0 0 52 57 8 8 8 8 8 8 8 8 8 8 8 86 13 13 13 13 13 14 13 171 
171 8 8 8 96 107 22 21 21 21 21 106 97 8 8 8 8 8 8 8 8 51 0 0 0 0 0 0 0 0 0 0 0 0 0 26 4 4 4 4 4 4 4 4 4 4 4 34 25 0 0 0 0 0 0 0 0 0 0 0 0 0 0 0 0 38 6 39 0 0 0 0 0 0 0 0 0 0 0 52 57 8 8 11 8 8 8 8 8 8 8 9 91 91 91 91 91 91 91 171 
171 9 8 8 98 21 21 21 21 21 22 21 99 8 8 8 8 8 8 8 8 51 0 0 0 2 0 0 0 0 0 0 0 0 0 28 33 4 5 4 4 4 4 4 4 5 4 4 27 0 0 0 0 0 0 0 0 0 0 0 0 0 0 36 42 47 6 39 0 0 0 0 0 0 0 0 0 0 0 0 52 57 8 8 8 9 8 8 8 8 8 8 8 96 97 8 8 9 8 171 
171 8 8 8 100 105 21 21 21 21 21 21 99 8 8 8 8 8 8 8 8 51 0 0 0 0 0 0 0 0 0 0 0 0 0 0 28 33 4 4 4 4 4 4 4 4 4 4 27 0 0 0 0 0 0 0 0 0 1 0 0 0 0 38 6 44 43 41 0 0 0 0 0 0 0 0 0 0 0 0 0 52 57 8 8 8 96 97 8 8 8 8 96 107 99 8 8 8 8 171 
171 8 8 8 8 100 105 22 21 21 21 21 99 8 8 8 8 8 8 8 8 51 0 0 0 0 0 0 0 0 0 0 0 0 0 0 0 26 4 4 4 4 4 4 4 4 4 4 34 25 0 1 0 0 0 0 0 0 0 0 0 0 0 38 7 39 0 0 0 0 0 0 0 0 0 0 0 0 0 0 0 0 50 8 8 8 98 106 102 102 97 8 100 103 101 8 8 56 55 171 
171 8 8 8 8 8 100 105 21 21 21 21 99 8 8 8 8 8 8 8 8 58 49 0 0 0 0 0 0 0 0 0 0 0 0 0 0 26 4 4 4 4 4 4 4 4 4 4 4 34 25 0 0 0 0 0 0 0 0 0 0 0 0 38 6 39 0 0 0 0 0 1 0 0 0 0 0 0 0 0 0 0 52 57 8 8 98 22 21 21 99 8 8 8 56 55 55 53 0 171 
171 8 8 8 8 8 8 98 21 22 22 104 101 8 8 8 8 8 8 9 8 8 58 49 0 0 1 0 0 1 0 0 0 0 1 0 0 28 33 4 5 4 4 5 5 4 4 4 4 4 34 25 0 0 0 0 0 1 0 0 0 0 0 38 6 39 0 0 0 0 0 0 0 0 0 0 0 0 0 0 0 0 0 50 9 8 98 21 22 21 99 8 9 56 53 0 0 0 0 171 
171 8 8 8 8 9 8 100 105 21 21 99 8 8 8 8 8 8 8 8 8 8 8 51 0 0 0 0 0 0 0 0 0 0 0 0 0 0 26 4 4 4 4 4 5 4 4 4 4 4 4 34 25 0 0 0 0 0 0 0 0 0 0 38 6 39 0 0 0 0 0 0 0 0 0 0 0 0 0 0 0 0 0 50 8 8 100 103 103 103 101 8 8 51 0 0 0 0 0 171 
171 8 9 8 8 8 8 8 98 21 104 101 8 8 8 8 8 8 8 8 8 8 8 51 0 0 0 0 0 0 0 0 0 0 0 0 0 0 28 33 4 4 4 5 4 4 4 5 5 5 4 4 27 0 0 0 0 0 0 0 0 60 71 38 6 39 0 0 0 0 0 0 0 0 0 0 0 0 0 0 0 0 0 52 57 8 8 8 8 8 8 8 56 53 0 0 0 0 0 171 
171 8 8 8 8 8 8 8 100 103 101 8 8 8 8 8 8 8 8 8 8 8 8 51 0 0 2 0 0 0 0 0 0 0 0 0 0 0 0 28 33 4 4 4 4 4 4 4 4 4 4 4 27 0 0 0 0 0 0 0 0 62 0 38 7 39 0 0 0 0 0 0 0 0 0 0 1 0 0 0 0 0 0 0 52 57 8 8 12 8 56 55 53 0 0 0 0 0 0 171 
171 8 8 8 8 8 8 8 8 8 8 8 8 8 8 8 8 8 8 8 8 8 8 58 54 49 0 0 0 0 0 0 0 0 0 0 0 0 0 0 28 33 4 4 4 4 4 4 4 4 4 4 34 30 25 0 0 0 0 0 0 62 0 38 6 39 0 0 0 0 0 0 0 0 0 0 0 0 0 0 0 0 0 0 0 52 57 8 8 56 53 0 0 0 1 0 0 0 0 171 
171 8 8 8 8 8 8 8 8 8 8 8 8 8 8 8 8 8 8 8 8 8 8 8 8 51 0 0 2 0 0 0 0 0 0 0 0 0 0 0 0 26 4 4 4 4 4 4 4 4 4 4 4 4 27 0 0 0 1 0 0 62 0 38 6 39 0 0 0 0 0 0 0 0 0 0 0 0 0 0 0 0 0 0 0 0 52 55 55 53 0 0 0 0 0 0 0 0 0 171 
171 8 8 9 8 8 8 8 8 8 9 8 8 8 8 8 9 8 8 8 8 8 8 8 8 51 0 0 0 0 0 0 0 0 0 0 0 0 0 0 0 28 33 4 4 4 5 4 4 4 4 5 4 4 27 0 0 0 0 0 0 62 0 38 6 39 0 0 0 0 0 0 0 0 0 0 0 0 0 0 0 0 0 0 0 0 0 0 0 0 0 0 0 0 0 0 0 0 0 171 
171 8 8 8 8 8 8 8 8 8 8 8 8 8 8 8 8 8 8 8 8 9 8 8 8 51 0 0 0 0 0 0 0 0 0 0 0 0 0 0 0 0 28 33 4 4 4 4 4 4 4 4 4 4 34 25 0 0 0 0 0 62 0 38 6 39 0 0 0 0 0 0 0 1 0 0 0 0 0 0 0 0 0 0 0 0 0 0 0 0 0 0 1 0 0 0 0 0 0 171 
171 55 55 55 55 55 55 55 55 55 55 55 55 55 57 8 8 8 8 8 8 8 8 8 8 58 49 0 0 0 0 0 0 0 1 0 0 0 0 0 0 0 0 28 33 4 4 4 4 4 4 4 4 4 4 34 25 0 0 0 0 62 0 38 6 39 0 0 0 0 0 0 0 0 0 0 0 0 0 1 0 0 0 0 0 0 0 0 0 0 0 0 0 0 0 0 0 0 0 171 
171 0 0 0 0 0 0 0 0 0 0 0 0 0 52 55 55 55 57 8 8 8 8 8 8 8 51 0 0 0 0 0 0 0 0 0 0 0 0 0 0 0 0 0 28 33 4 4 4 4 4 4 4 4 4 4 27 0 0 0 0 64 69 38 7 39 0 0 0 0 0 0 0 0 0 0 0 0 0 0 0 0 0 0 0 0 0 0 0 0 0 0 0 0 0 0 0 0 0 171 
171 0 0 2 0 0 0 0 0 0 0 0 1 0 0 0 0 0 52 57 8 8 8 8 8 8 51 0 0 0 0 0 0 0 0 0 0 0 0 0 0 0 0 0 0 28 33 4 4 4 4 4 4 4 4 4 27 0 0 0 0 0 0 38 6 39 0 0 0 0 0 0 0 0 0 0 0 0 0 0 0 0 0 0 0 0 0 0 0 0 0 0 0 0 0 0 0 0 0 171 
171 0 0 0 0 0 0 0 0 0 0 0 0 0 0 0 0 2 0 52 55 57 8 8 8 56 53 0 0 0 0 0 0 0 0 0 0 0 0 0 0 0 0 0 0 0 28 33 4 4 4 4 4 4 4 4 34 25 0 0 0 0 0 38 6 39 0 0 0 0 0 0 0 0 24 30 30 25 0 0 0 0 0 0 24 30 30 30 30 30 30 25 0 0 0 0 0 0 0 171 
171 0 0 0 1 0 0 0 0 0 2 0 0 0 0 0 0 0 0 0 0 52 55 55 55 53 0 0 0 2 0 0 0 0 0 0 0 1 0 0 0 0 0 0 0 0 0 28 33 4 5 4 4 5 4 4 4 27 0 0 0 0 0 38 6 39 0 0 0 0 0 0 0 0 26 4 4 27 0 0 0 0 0 0 26 4 4 4 4 4 4 27 0 0 0 0 0 0 0 171 
171 0 0 0 0 0 0 0 0 0 0 0 0 1 0 0 0 0 1 0 0 0 0 0 0 0 0 0 0 0 0 0 0 0 0 0 0 0 0 0 0 0 0 0 0 1 0 0 28 33 4 4 4 4 4 4 4 34 25 0 0 1 0 38 6 39 0 0 0 0 0 0 0 0 26 4 4 27 0 0 24 30 30 30 35 4 4 4 5 4 4 27 0 0 0 0 0 0 0 171 
171 0 0 0 0 0 0 0 0 0 0 0 0 0 0 0 0 0 0 0 0 0 0 0 0 1 0 0 0 0 0 0 0 0 0 0 0 0 0 0 0 0 0 0 0 0 0 0 0 26 4 4 4 4 4 4 4 4 27 0 0 0 0 38 6 46 42 42 42 42 42 37 0 0 26 4 4 34 25 0 26 4 4 4 4 4 4 4 4 32 31 29 0 0 0 0 0 0 0 171 
171 0 0 0 1 0 0 0 0 0 0 0 0 0 0 0 0 0 0 0 0 0 0 0 0 0 0 0 0 0 0 0 0 0 0 0 0 0 0 0 0 0 0 0 0 0 0 0 0 28 33 4 4 5 4 4 4 4 27 0 0 0 0 38 6 6 6 6 6 7 6 39 0 0 26 4 5 4 34 30 35 4 4 4 4 4 5 4 4 27 0 0 0 0 0 0 0 0 0 171 
171 0 0 0 1 0 0 0 60 66 66 66 66 66 66 66 66 0 66 66 61 0 0 0 0 0 0 0 0 0 0 0 0 0 0 0 0 0 0 0 0 0 0 0 0 0 1 0 0 0 26 4 4 4 4 4 4 4 27 0 0 0 0 38 6 44 43 43 43 43 43 41 0 0 26 4 4 4 4 4 4 5 4 4 4 4 4 4 4 27 0 0 0 0 0 1 0 0 0 171 
171 0 0 0 0 0 0 0 62 36 42 42 42 42 42 42 42 42 42 37 63 0 0 0 0 0 0 0 0 0 0 0 0 0 1 0 0 0 0 0 0 0 0 0 0 0 0 0 0 0 26 4 4 4 4 4 4 5 27 0 0 0 0 38 6 39 0 0 0 0 0 0 0 0 26 4 4 4 4 4 4 4 4 4 4 4 4 4 32 29 0 0 0 0 0 0 0 0 0 171 
171 0 0 0 0 0 0 0 62 38 6 6 6 6 6 6 6 6 6 39 70 66 66 66 66 66 61 0 0 0 0 0 0 0 0 0 0 0 0 0 0 0 0 0 0 0 0 0 0 0 26 4 4 4 4 4 4 4 27 0 0 0 0 38 7 39 0 0 0 0 0 0 0 0 26 4 4 4 5 4 4 4 4 4 4 4 4 4 34 30 25 0 0 0 0 0 0 0 0 171 
171 0 0 0 0 1 0 0 62 38 6 6 6 44 43 45 6 6 6 46 42 42 42 42 42 37 63 0 0 0 0 0 0 0 0 0 0 0 0 0 0 0 0 0 0 0 0 0 0 0 26 4 4 4 4 4 4 4 27 0 0 0 0 38 6 39 0 0 0 0 0 0 0 0 26 4 4 4 4 4 4 4 4 4 4 4 5 4 4 4 34 25 0 0 0 0 0 0 0 171 
171 0 0 0 0 0 0 0 0 38 6 6 7 39 3 38 7 6 6 6 6 6 6 6 6 39 63 0 0 0 1 0 0 0 0 0 0 0 0 0 0 0 0 0 0 0 0 0 0 0 26 4 4 4 4 4 4 4 27 0 0 0 0 38 6 39 0 0 0 0 0 0 0 0 28 31 31 31 31 31 31 31 31 33 4 4 4 32 31 31 31 29 0 0 0 0 0 0 0 171 
171 0 0 0 0 0 0 0 62 38 6 6 6 46 42 47 6 6 6 6 6 6 6 6 6 39 63 0 0 0 0 0 0 0 0 0 0 0 0 0 1 0 0 0 0 0 0 0 0 0 26 4 4 4 4 4 4 4 27 0 0 0 0 38 6 39 0 0 0 0 1 0 0 0 0 0 0 0 0 0 0 0 0 26 4 4 4 27 0 0 0 0 0 0 1 0 0 0 0 171 
171 0 0 0 0 0 0 0 62 38 6 6 6 6 6 6 6 6 6 7 6 6 6 6 6 39 63 0 0 0 0 0 0 0 0 0 0 0 0 0 0 0 0 0 0 0 0 0 0 0 26 4 4 5 4 4 4 4 27 0 0 0 0 38 6 39 0 0 0 0 0 0 0 0 0 0 0 0 0 0 0 0 0 28 31 31 31 29 0 0 0 0 0 0 0 0 0 0 0 171 
171 0 0 0 0 0 0 0 62 38 6 6 7 6 6 6 6 6 6 6 6 6 6 7 6 39 63 0 0 0 0 0 0 0 0 0 0 0 0 0 0 0 0 0 0 0 0 0 0 0 26 4 4 4 4 4 4 4 27 0 0 0 0 38 6 39 0 0 0 0 0 0 0 0 0 1 0 0 0 0 0 0 0 0 0 0 0 0 0 0 0 0 0 0 0 0 0 0 0 171 
171 0 0 1 0 0 0 0 62 40 43 43 43 43 43 43 43 43 43 45 6 6 6 6 6 39 63 0 0 3 0 36 37 0 0 0 0 0 0 0 0 0 0 0 0 0 0 156 157 157 158 159 159 159 159 159 159 159 160 157 161 0 0 38 6 39 0 0 0 0 0 0 0 0 0 0 0 0 0 0 0 0 0 0 0 0 0 0 0 0 0 0 0 0 0 0 0 0 0 171 
171 0 0 0 0 0 0 0 64 66 66 66 66 66 66 66 66 66 69 38 6 6 6 6 6 39 0 3 0 1 0 40 41 0 0 0 0 0 0 0 0 0 0 0 0 1 0 168 169 169 169 169 169 169 169 169 169 169 169 169 170 36 42 47 6 46 42 42 42 42 42 42 42 42 42 42 42 42 42 42 42 37 0 0 0 1 0 0 0 0 0 0 0 0 0 0 1 0 0 171 
171 0 0 0 0 0 0 0 0 0 0 0 0 0 0 0 0 0 62 38 6 6 6 7 6 39 63 0 3 0 3 0 0 0 36 42 37 0 0 0 36 42 42 42 42 42 37 168 169 169 169 169 169 169 169 169 169 169 169 169 170 38 6 7 6 6 6 6 6 6 7 6 6 6 6 6 6 6 6 6 6 39 0 0 0 0 0 0 1 0 0 0 0 0 0 0 0 0 0 171 
171 0 0 0 0 0 0 0 0 0 0 0 0 0 0 0 0 0 62 38 6 6 6 6 6 39 63 0 0 0 0 0 3 0 40 45 46 37 0 0 38 6 6 7 6 6 39 168 169 169 169 169 169 169 169 169 169 169 169 169 170 38 6 6 6 6 7 6 6 6 6 6 6 6 6 6 6 6 7 6 6 39 0 0 0 0 0 0 0 0 0 0 0 0 0 0 0 0 0 171 
171 0 0 0 0 0 24 30 25 0 0 0 0 0 0 0 0 0 62 38 6 6 6 6 6 39 63 0 0 0 0 0 0 0 0 40 43 41 1 0 40 43 43 43 43 43 41 168 169 169 169 169 169 169 169 169 169 169 169 169 170 40 43 43 43 43 43 43 43 43 43 43 43 43 43 43 43 43 45 6 6 39 0 0 0 0 0 0 0 0 0 0 0 0 0 0 0 0 0 171 
171 0 0 0 0 0 26 4 27 0 0 0 0 0 0 1 0 0 62 38 6 7 6 6 6 39 63 0 0 0 0 0 0 0 0 0 0 0 0 0 0 0 0 0 0 0 0 162 163 164 165 165 165 165 165 165 166 163 163 163 167 0 0 0 0 0 0 0 0 0 0 0 0 0 0 0 0 0 38 6 6 39 0 0 0 0 0 0 0 0 0 0 1 0 0 0 0 0 0 171 
171 0 0 0 0 0 28 31 29 0 0 0 0 0 0 0 0 0 62 38 6 6 6 6 6 39 63 0 0 0 0 0 0 0 0 0 0 0 0 0 0 0 0 0 0 0 0 0 24 35 4 4 4 4 5 4 27 0 0 0 0 1 0 0 0 0 0 0 0 0 0 0 0 0 1 0 0 0 38 6 6 39 0 0 0 0 0 0 0 0 0 0 0 0 0 0 0 0 0 171 
171 0 0 0 0 0 0 0 0 0 0 0 0 0 0 0 0 0 62 40 43 43 43 43 43 41 63 0 0 0 0 0 0 0 0 0 0 0 0 0 0 0 0 0 0 1 0 0 26 4 5 4 4 4 4 4 27 0 0 0 0 0 0 0 0 0 1 0 0 0 0 0 0 0 0 0 0 0 38 6 7 39 0 0 0 0 0 0 0 0 0 0 0 0 0 0 0 0 0 171 
171 0 0 0 0 0 0 0 0 0 0 0 0 0 0 1 0 0 64 66 66 66 66 0 66 66 65 0 0 0 1 0 0 0 0 0 1 0 0 0 0 0 0 0 0 0 0 0 26 4 4 4 5 4 32 31 29 0 0 0 0 0 0 0 0 0 0 0 0 0 0 0 0 0 0 0 0 0 38 6 6 39 0 0 1 0 0 0 0 0 0 0 0 0 0 0 0 0 0 171 
171 0 0 0 1 0 0 0 0 0 0 0 0 0 0 0 0 0 0 0 0 0 0 0 0 0 0 0 0 0 0 0 0 0 0 0 0 0 0 0 0 0 0 0 0 0 0 24 35 4 4 4 4 4 27 0 0 0 0 0 0 0 0 0 0 0 0 0 0 0 1 0 0 0 0 0 0 0 38 6 6 39 0 0 0 0 0 0 0 0 0 0 0 0 0 0 0 0 0 171 
171 0 0 0 0 0 0 0 0 0 0 0 0 0 0 0 0 0 0 0 0 0 0 0 0 0 0 0 0 0 0 0 0 0 0 0 0 0 0 0 0 0 0 0 0 0 24 35 4 4 4 4 4 4 27 0 0 0 0 0 0 0 0 0 0 0 0 0 0 0 0 0 0 0 0 0 0 0 38 6 6 39 0 0 0 0 0 0 0 0 0 0 0 0 0 0 0 0 0 171 
171 0 0 0 0 0 0 0 0 0 0 0 0 0 0 0 0 0 0 0 0 0 0 0 0 0 0 48 54 54 54 54 54 49 0 0 0 0 0 0 0 1 0 0 0 0 26 4 4 4 4 4 4 4 27 0 1 0 0 0 1 0 0 0 0 0 0 0 0 0 0 0 0 0 0 0 0 1 38 6 6 39 0 0 0 0 0 0 0 0 0 0 0 0 0 1 0 0 0 171 
171 0 0 0 0 0 0 0 0 0 0 1 0 0 0 0 0 0 0 0 0 0 0 0 0 48 54 59 8 8 8 12 8 58 54 54 49 0 0 0 0 0 0 0 0 0 26 4 4 5 4 4 4 4 27 0 0 0 0 0 0 0 0 0 0 0 0 0 0 0 0 0 0 0 0 0 0 0 38 6 6 39 0 0 0 0 0 0 0 0 0 0 0 0 0 0 0 0 0 171 
171 0 0 0 0 0 0 0 0 0 0 0 0 0 0 0 0 0 0 0 0 0 48 54 54 59 8 8 8 8 8 8 8 8 8 8 58 54 49 0 0 0 0 0 0 24 35 4 4 4 4 4 4 4 27 0 0 0 0 0 0 0 0 0 0 0 0 0 0 0 0 0 0 0 0 0 0 0 38 6 6 39 0 0 0 0 0 0 0 0 0 0 0 0 0 0 0 0 0 171 
171 0 0 0 0 1 0 0 0 0 0 0 0 0 0 0 0 1 0 0 0 0 50 8 8 8 8 8 8 8 8 8 8 8 8 8 8 8 58 54 49 0 0 0 24 35 4 4 4 4 4 4 5 32 29 0 0 0 0 0 0 0 1 0 0 0 0 0 0 0 1 1 0 0 0 0 0 0 38 6 6 39 0 0 0 0 0 0 0 0 1 0 0 0 0 0 0 0 0 171 
171 0 0 0 0 0 0 0 0 0 0 0 0 0 0 0 0 0 0 0 0 48 59 12 8 8 8 8 9 8 8 8 11 8 8 8 8 8 8 12 58 54 49 0 26 4 4 4 4 4 4 4 4 27 0 0 0 0 0 0 0 0 0 0 0 0 0 0 0 0 0 0 0 0 0 0 0 0 38 6 6 39 0 0 0 0 0 0 0 0 0 0 0 0 0 0 0 0 0 171 
171 0 0 0 0 0 0 0 0 0 0 0 0 0 0 0 0 0 0 0 48 59 8 8 8 9 8 8 8 8 8 8 8 8 9 8 8 8 8 8 8 8 72 30 35 4 4 4 4 4 4 4 32 29 0 0 0 0 0 0 0 0 0 0 0 0 0 0 0 0 0 0 0 67 67 67 67 71 38 6 6 39 70 67 67 67 67 0 0 0 0 0 0 0 0 0 0 1 0 171 
171 0 0 0 0 0 0 0 0 0 0 0 0 0 1 0 0 0 0 0 50 8 8 8 8 8 8 8 8 11 8 8 8 8 8 8 8 9 8 8 8 8 74 4 4 4 4 5 4 4 4 4 27 0 0 1 0 0 0 0 0 0 0 0 0 0 0 0 0 0 36 42 42 42 42 42 42 42 47 6 6 46 42 42 42 42 42 42 42 37 0 0 0 0 0 0 0 0 0 171 
171 0 0 0 1 0 0 0 0 0 0 0 0 0 0 0 0 0 48 54 59 8 8 8 84 90 90 90 90 90 90 90 90 85 8 8 8 8 8 8 8 72 83 4 4 5 4 4 4 4 4 4 27 0 0 0 0 0 0 0 0 0 0 0 0 0 1 0 0 0 38 6 6 44 43 45 6 6 6 7 6 6 44 43 45 6 6 6 6 39 0 0 0 0 0 0 0 0 0 171 
171 0 0 0 0 0 0 0 0 0 0 0 0 0 0 0 0 0 50 8 8 8 8 84 95 13 13 13 13 13 13 13 13 94 85 8 11 8 8 8 8 74 4 4 4 4 4 4 4 4 4 80 29 0 0 0 0 0 0 0 0 0 0 0 0 0 0 0 0 0 38 7 6 39 3 38 6 6 6 6 6 6 39 3 38 6 44 43 45 39 0 0 0 0 0 0 1 0 0 171 
171 0 0 0 0 0 0 0 0 0 0 0 0 0 0 0 0 48 59 8 8 8 8 86 13 13 14 13 13 13 13 14 13 13 94 85 8 8 8 8 8 74 4 4 4 4 4 4 4 4 80 77 58 54 54 49 0 0 1 0 0 0 0 0 0 0 0 0 0 0 38 6 6 46 42 47 6 6 6 6 6 6 46 42 47 6 39 3 38 39 0 0 0 0 0 0 0 0 0 171 
171 0 0 0 0 0 0 0 0 1 0 0 0 0 0 0 0 50 8 8 8 11 8 86 13 13 13 13 13 13 13 13 13 14 13 87 8 8 8 9 8 74 4 4 4 4 4 4 4 4 82 73 8 12 8 51 0 0 0 0 0 0 0 0 0 0 0 0 0 0 38 44 43 45 6 7 6 6 44 43 45 6 6 6 6 6 46 42 47 39 0 0 0 0 0 0 0 0 0 171 
171 0 0 0 1 0 0 0 0 0 0 0 0 0 0 0 48 59 8 8 8 8 8 86 13 14 13 13 13 13 13 13 13 13 13 87 8 8 8 8 8 74 4 4 4 4 4 4 4 4 80 77 8 9 8 58 49 0 0 0 0 0 0 0 0 0 0 0 0 0 38 39 3 38 6 6 6 6 39 3 38 6 7 6 6 6 6 6 6 39 0 0 0 0 0 0 0 0 0 171 
171 0 0 0 0 0 0 0 0 0 0 0 0 0 48 54 59 8 8 9 8 8 8 88 93 13 13 13 13 14 13 13 13 13 13 87 8 11 8 8 72 83 4 4 4 4 4 4 4 4 75 8 8 8 8 8 51 0 0 0 0 0 0 0 0 0 0 0 0 0 38 46 42 47 6 6 6 6 46 42 47 6 6 6 6 6 6 7 6 39 0 0 0 0 0 0 0 0 0 171 
171 0 0 0 0 0 0 0 0 0 0 0 0 0 50 8 8 9 8 8 8 8 8 8 88 93 13 13 13 13 13 13 14 92 91 89 8 8 8 8 74 4 4 5 4 4 4 4 5 4 75 8 8 8 8 8 58 49 0 0 0 0 0 0 0 0 0 0 0 0 40 43 43 43 43 43 43 43 43 43 43 43 43 43 43 45 44 43 45 39 0 0 0 0 1 0 0 0 0 171 
171 0 0 0 0 0 0 0 0 0 0 0 48 54 59 8 8 8 8 8 8 8 9 8 8 88 91 91 91 91 91 91 91 89 8 8 8 8 8 8 74 4 4 4 4 4 4 4 4 80 77 8 8 8 9 8 8 51 0 0 0 0 0 0 0 0 0 0 0 0 0 0 0 0 0 0 0 0 0 0 0 0 0 0 0 38 39 3 38 39 0 0 0 0 0 0 0 0 0 171 
171 0 0 1 0 0 0 0 0 1 0 0 50 8 8 8 8 8 8 8 8 8 8 8 8 8 8 8 8 8 8 8 8 8 8 8 8 8 8 8 74 4 4 4 4 4 4 4 4 75 8 9 8 8 8 8 12 51 0 0 0 0 0 0 0 0 0 0 0 0 0 0 0 0 0 0 0 0 1 0 0 0 0 0 0 38 46 42 47 39 0 0 0 0 0 0 0 0 0 171 
171 0 0 0 0 0 0 0 0 0 48 54 59 8 8 8 8 8 72 78 78 78 78 78 78 78 73 8 8 11 8 8 8 8 8 8 8 9 8 8 74 4 4 4 4 4 4 4 4 75 8 8 8 8 8 8 8 51 0 1 0 0 0 1 0 0 0 0 0 0 0 0 0 0 0 0 0 0 0 0 0 0 0 0 0 40 43 43 43 41 0 0 0 0 0 0 0 1 0 171 
171 0 0 0 0 0 0 0 0 0 50 8 8 8 8 8 8 72 83 5 4 4 4 4 4 4 75 8 8 8 8 8 8 9 8 8 8 8 8 8 74 4 4 4 4 4 4 4 80 77 8 8 9 8 8 8 8 51 0 0 0 0 0 0 0 0 0 0 0 0 0 0 0 1 0 0 0 0 0 1 0 0 0 0 0 0 0 0 0 0 0 1 0 0 0 0 0 0 0 171 
171 0 0 0 0 0 0 0 48 54 59 8 8 8 9 8 8 74 4 4 4 4 4 5 4 4 75 8 8 8 9 8 8 8 8 8 8 8 8 72 83 4 4 5 4 4 4 4 75 8 8 8 8 12 8 9 8 51 0 0 0 0 0 0 0 0 0 0 0 0 0 0 0 0 0 0 0 0 0 0 0 0 0 0 0 0 0 0 0 0 0 0 0 0 0 0 0 0 0 171 
171 171 171 171 171 171 171 171 171 171 171 171 171 171 171 171 171 171 171 171 171 171 171 171 171 171 171 171 171 171 171 171 171 171 171 171 171 171 171 171 171 171 171 171 171 171 171 171 171 171 171 171 171 171 171 171 171 171 171 171 171 171 171 171 171 171 171 171 171 171 171 171 171 171 171 171 171 171 171 171 171 171 171 171 171 171 171 171 171 171 171 171 171 171 171 171 171 171 171 171 
